###################
#E#   #           #
# # # # ######### #
# # # #       # # #
# # # ####### # ### 
# # #         #   #   
# # ######### # # #  
# #      #    # # #  
# ###### # #### # #
#        #      # #
################# # 
#            #    #
# ##### #### # ####
#S#   # #    # #  #
### # # # #### ## #
#   #   #         #
###################